W	W	W	W	W	W	W	W	W	W	W
W	P	F	F	F	F	F	F	F	F	W
W	F	F	F	F	F	F	F	F	F	W
W	F	F	F	F	F	F	F	F	F	W
W	F	F	F	F	F	F	F	F	F	W
W	F	F	F	F	F	F	F	F	F	W
W	F	F	F	F	F	F	F	F	F	W
W	F	F	F	F	F	F	F	F	F	W
W	F	F	F	F	F	F	F	F	F	W
W	F	F	F	F	F	F	F	F	F	W
W	F	F	F	F	F	F	F	F	F	W
W	F	F	F	F	F	F	F	A	F	W
W	F	F	F	F	F	F	F	F	F	W
W	W	W	W	W	W	W	W	W	W	W