W	W	W	W	W	W	W	W	W	W	W	W	W	W	W
W	A	W	A	F	F	F	W	F	F	F	F	F	A	W
W	F	W	F	F	F	F	F	F	F	F	W	F	F	W
W	F	W	F	F	F	F	W	F	F	F	W	F	W	W
W	F	W	F	F	F	W	W	W	F	F	W	F	W	W
W	F	W	F	F	F	F	F	F	F	F	W	F	W	W
W	F	W	F	F	F	F	F	F	F	F	W	F	W	W
W	F	W	F	F	F	F	P	F	F	F	W	F	W	W
W	F	W	F	F	W	W	W	W	W	F	W	F	W	W
W	F	W	F	F	F	F	W	F	F	F	W	F	W	W
W	F	W	F	F	F	F	W	F	F	F	W	F	W	W
W	F	W	F	F	F	F	F	F	F	F	W	F	W	W
W	F	W	F	F	F	F	W	F	F	F	F	F	F	W
W	A	F	F	W	F	F	W	F	F	F	W	F	A	W
W	W	W	W	W	W	W	W	W	W	W	W	W	W	W
